Mapa 1:
4 4 4 0 0 0 0 
6 6 0 0 0 0 0 
2 2 2 2 0 0 0 
0 0 0 0 0 0 0 
0 0 0 0 0 0 0 
0 0 0 0 0 0 0 
0 0 0 0 0 0 0 

Mapa 2:
0 0 0 0 0 0 0 
0 0 0 0 0 0 0 
4 4 4 6 0 0 0 
0 0 0 6 0 0 0 
0 0 0 6 0 2 0 
0 0 0 6 0 2 0 
4 0 0 0 0 0 0 
